#######################################################
#         #         #         #     #   #     #       #
#######   #         #   # #   #  ####   # ##  ######  #
#           ##   ## #         #                       #
#  ##       ##   ## #  ####   #  #####  ####          #
#                      #                   #    #     #
#  ####   ####     #####      #####             #     #
#     #         #             #                 # #   #
#  ## ###   #   #####   ###   #####   ######### # #   #
#           #                         #         #     #
######   ##   ####### #######     #       #############
#             #                   #                   #
#   #######   #     #######  ######       #  #  #  ####
#                         #               #  #  #     #
#   #####       ###   ##  #  ##########   ####  #     #
# #     #       #                         #           #
# #     # ##  # ###   ##            ###   #   #   #   #
#       #     #               ###   #     #   #   #   #
#       #######    ##       #####   # ##  #   #       #
#     #                             #         #       #
#######################################################
